ㅇㅣㅂㅓㄴㅇㅔㄴ	I B EO N E N
ㅈㅏㄱㄴㅕㄴ	J A NG N iEO N
ㅇㅣㄹㅇㅛㅇㅣㄹㅇㅣ	I R iO I R I
ㅈㅏㄹ	J A L
ㅈㅏㄹ	J A R
ㄱㅏㅁㅅㅏㅎㅏㅂㄴㅣㄷㅏ	G A M S A A M N I D A
ㄷㅚㅂㄴㅣㄷㅏ	D OE M N I D A
ㄴㅓㅎㅇㅓㅇㅛ	N EO EO iO
ㅊㅏㅁ	CHh A M
ㅁㅏㄴㄷㅡㄴㅡㄴ	M A N D EU N EU N
ㅇㅡㅁㅅㅣㄱ	EU M S I k
ㅁㅜㄴㅇㅏㄴ	M U N A N
ㅎㅏㅇㅅㅏㅇ	H A NG S A NG
ㅇㅓㄹㄱㅜㄹ	EO L G U L
ㅇㅓㄹㄱㅜㄹ	EO L G U R
ㅎㅚㅇㅢ	OE euI
ㅎㅚㅇㅢ	H OE euI
ㄱㅟ	G UE
ㄱㅡㄱㅓㅅㄷㅗ	G EU G EO t DD O
ㅈㅜㄹㄴㅓㅁㄱㅣ	J U N N EO M G I
ㅎㅏㅅㅕㅆㅇㅓㅇㅛ	H A S iEO SS EO iO
ㅂㅜㅁㅗㄴㅣㅁ	B U M O N I M
ㅈㅗㅎㄷㅏ	J O Th A
ㄱㅏㅈㅗㄱㅇㅣ	G A J O G I
ㅈㅓㄴㅡㄴ	J EO N EU N
ㅈㅚㅅㅗㅇㅎㅐㅅㅓ	J OE S O NG H AE S EO
ㅈㅏㅇㅕㄴㅅㅡㄹㅓㅂㄱㅔ	J A iEO N S EU R EO p GG E
ㅈㅗㅎㅇㅏㅇㅛ	J O A iO
ㅂㅣㅊㅇㅡㄹ	B I CHh EU L
ㅈㅗㄱㅡㅁㅇㅣㅈㅣ	J O G EU M I J I
ㅆㅏㄷㅏ	SS A D A
ㄱㅣㄹㅇㅣ	G I R I
ㄱㅏㄴㅈㅏㅇ	G A N J A NG
ㅈㅓㄴㅎㅏㄹ	J EO N A L
ㄱㅏㄹㅂㅣ	G A L B I
ㅅㅣㅂㅁㅏㄴ	S I M M A N
ㅇㅏㄵㄱㅗ	A N G O
ㅇㅕㄹㅇㅓㅆㅇㅓㅇㅛ	iEO R EO SS EO iO
ㄴㅏㅈㅜㅇㅇㅔ	N A J U NG E
ㅈㅗㅎㅅㅡㅂㄴㅣㄷㅏ	J O SS EU M N I D A
ㅁㅐㄱㄹㅏㄱ	M AE NG N A k
ㅁㅐㄱㄹㅏㄱ	M AE NG N A G
ㄱㅡㄹㅡㅅ	G EU R EU S
ㄱㅗㅇㅉㅏ	G O NG JJ A
ㅅㅔㅅㅜ	S E S U
ㄱㅏ	G A
ㅂㅘ	B oA
ㄱㅏㄹㄷㅡㅇ	G A L D EU NG
ㅋㅕㄹㄹㅔ	Kh iEO L L E
ㅇㅕㄹㄹㅕㅆㄴㅔㅇㅛ	iEO L L iEO N N E iO
ㄱㅗㅈㅓ	Kh O J EO
ㅇㅚㄱㅜㄱ	OE G U k
ㅂㅏㄷㅇㅏㅆㄷㅏ	B A D A t D A
ㅂㅕㅇㅇㅝㄴ	B iEO NG uEO N
ㅈㅓㅅㄱㅏㄹㅏㄱ	J EO t GG A R A k
ㄷㅔ	D E
ㅁㅏㄱ	M A G
ㅁㅏㄱ	M A k
ㅁㅏㄱ	M A NG
ㅁㅏㄱ	M A Kh
ㄷㅏㅇㅡㅁ	D A EU M
ㄱㅗㅇㄱㅝㄴㄹㅕㄱㅇㅢ	G O NG G uEO N N iEO G euI
ㅇㅗㅅㅔㅇㅛ	O S E iO
ㅇㅏㄶㅇㅡㄹㄲㅏ	A N EU L GG A
ㄸㅗ	D O
ㄸㅗ	DD O
ㅅㅐ	S AE
ㄴㅗㄹㅕㄱ	N O R iEO k
ㅅㅟㄹ	S UE L
ㄴㅏㅈㅇㅏㅇㅛ	N A J A iO
ㅁㅕㅇㅇㅣㅇㅔㅇㅛ	M iEO NG I E iO
ㅅㅗㄹㅣ	S O R I
ㄴㅏㄱㅏ	N A G A
ㄲㅡㄶㅈㅣㅁㅏㄴ	GG EU N CHh I M A N
ㄱㅏㅁㄱㅣ	G A M G I
ㅂㅗㅅㅕㅆㅇㅓㅇㅛ	B O S iEO SS EO iO
ㅃㅏㄹㅡㄹㅅㅜㄹㅗㄱ	B A R EU L S U R O k
ㅃㅏㄹㅡㄹㅅㅜㄹㅗㄱ	BB A R EU L S U R O k
ㅇㅕㄱㅣ	iEO G I
ㅁㅏㄶㅇㅣ	M A N I
ㅁㅏㄹㅆㅡㅁㅇㅡㄹ	M A L SS EU M EU L
ㄷㅏㄴㅣㄴㅣ	D A N I N I
ㅈㅓㄴㅎㅘㅎㅏㄹㄱㅔ	J EO N oA A L G E
ㅈㅓㄴ	J EO N
ㅇㅡㄴㅎㅐㅇ	EU N AE NG
ㅁㅜㄹㅡㅍ	M U R EU p
ㅇㅏㅅㅔㅇㅛ	A S E iO
ㅈㅗㅅㅏ	J O S A
ㅈㅣㄹㅁㅜㄴ	J I L M U N
ㅇㅡㅁㄹㅛㅅㅜㅎㅏㄱㅗ	EU M N iO S U A G O
ㅎㅐㅆㄱㅜㄴㅏ	H AE t GG U N A
ㅇㅏㅈㅜ	A J U
ㅈㅜㅅㅣㅈㅣ	J U S I J I
ㅌㅏㅇㅛ	Th A iO
ㅇㅣㅆㅇㅡㄹ	I SS EU L
ㄱㅡㄹㅣㅁ	G EU R I M
ㄱㅚㅁㅜㄹ	G OE M U L
ㅇㅣㅆㄱㅜㄴㅏ	I t GG U N A
ㅁㅣㅇㅏㄴ	M I A N
ㅂㅣㄹㄹㅕㅈㅜㄹ	B I L L iEO J U L
ㅈㅣㅂㅇㅔ	J I B E
ㅇㅛㅇㄷㅗㄴㅇㅡㄴ	iO NG D O N EU N
ㅂㅜㄹㅂㅜㅌㅓ	B U L B U Th EO
ㅇㅓㄷㅣㅇㅔㅅㅓ	EO D I E S EO
ㅅㅜㅇㅓㅂ	S U EO p
ㅅㅜㅇㅓㅂ	S U EO M
ㄴㅐㅇㅛㅇㅇㅡㄹ	N AE iO NG EU L
ㄴㅐㅇㅣㄹ	N AE I R
ㄴㅐㅇㅣㄹ	N AE I N
ㅂㅜㄹㅓㅂㅈㅣ	B U R EO p JJ I
ㅇㅜㄹㅣ	U R I
ㅌㅚㄱㅡㄴㅅㅣㄱㅏㄴㅇㅣㄹㅏㅅㅓ	Th OE G EU N S I G A N I R A S EO
ㄷㅡㄹㅇㅓㅆㄴㅡㄴㄷㅔ	D EU R EO N N EU N D E
ㅂㅏㄹㅏㅂㄴㅣㄷㅏ	B A R A M N I D A
ㄴㅕㄴ	N iEO N
ㅁㅗㅅ	M O t
ㅁㅗㅅ	M O N
ㅁㅗㄹㄹㅏㅆㄴㅡㄴㄷㅔ	M O L L A N N EU N D E
ㄱㅡㅂㅎㅏㄷㅏ	G EU Ph A D A
ㅈㅓㅇㅁㅏㄹ	J EO NG M A L
ㅇㅜㄴㄷㅗㅇㅎㅘㄹㅡㄹ	U N D O NG H oA R EU L
ㄱㅜㄱㅇㅣ	G U G I
ㅂㅜㄹㅇㅡㄹ	B U R EU L
ㅅㅟㄷㅏ	S UE D A
ㅂㅏㅋㅟ	B A Kh UE
ㅍㅏㅇㅏㄱㅎㅏㅈㅣ	Ph A A Kh A J I
ㄱㅏㅇㅡㄹ	G A EU L
ㅁㅏㄱㅎㅣㄴㅏ	M A Kh I N A
ㄱㅡㄱㅓ	G EU G EO
ㅈㅜㅅㅣㅁㅕㄴ	J U S I M iEO N
ㄱㅡㅁㅇㅛㅇㅣㄹㅇㅣ	G EU M iO I R I
ㅇㅣㅂ	I B
ㅇㅣㅂ	I p
ㅇㅣㅂ	I M
ㅇㅣㅂ	I Ph
ㄴㅡㅈㅇㅡㅅㅣㅁㅕㄴ	N EU J EU S I M iEO N
ㅅㅐㅇㄱㅣㄴ	S AE NG G I N
ㅊㅏㅈㅇㅏㅈㅜㅅㅕㅅㅓ	CHh A J A J U S iEO S EO
ㄱㅓㅅㅇㅣ	G EO S I
ㄴㅡㅈㅇㅓㅆㅇㅓ	N EU J EO SS EO
ㅈㅜㅅㅣㄱㅣ	J U S I G I
ㅇㅏㅇㅣㅅㅡㅋㅡㄹㅣㅁ	A I S EU Kh EU R I M
ㅂㅏㄹ	B A L
ㅂㅏㄹ	B A R
ㅁㅜㅅㅡㄴ	M U S EU N
ㄱㅕㄱㄹㅕ	G iEO NG N iEO
ㅂㅓㅂㅇㅝㄴ	B EO B uEO N
ㅎㅏㅂㅂㅓㅂㅈㅓㄱㅇㅡㄹㅗ	H A p BB EO p JJ EO G EU R O
ㄷㅏㄷㄴㅡㄴ	D A N N EU N
ㅉㅣㄷㅏ	J I D A
ㅉㅣㄷㅏ	JJ I D A
ㅈㅓㄻㄱㅗ	J EO L M G O
ㅇㅓㄸㅓㄴ	EO DD EO N
ㄱㅏㅅㅓ	G A S EO
ㅎㅓㄹㅣ	H EO R I
ㅅㅣ	S I
ㅌㅔㄴㄷㅔㅇㅛ	Th E N D E iO
ㄷㅓㅇㅝㅇㅛ	D EO uEO iO
ㅇㅡㄴㅎㅐㅇㅇㅣ	EU N AE NG I
ㅍㅜㄹ	Ph U L
ㅇㅏㄹㅇㅏㅆㄷㅏㅁㅕㄴ	A R A t DD A M iEO N
ㅁㅜㄴㅢ	M U N euI
ㅇㅗㅅㅕㅆㅇㅓㅇㅛ	O S iEO SS EO iO
ㅇㅣ	I
ㄷㅡㅅㅣㄹ	D EU S I L
ㄷㅡㅅㅣㄹ	D EU S I N
ㅅㅣㄱㅖ	S I G iE
ㅇㅞㄴㅇㅣㄹㄹㅗ	U E N I L L O
ㅆㅓ	SS EO
ㅆㅓ	S EO
ㄱㅜㄷㅜ	G U D U
ㅁㅏㅅㅇㅣㅆㄷㅏ	M A S I t DD A
ㄴㅜㄱㅏ	N U G A
ㄱㅓㄹ	G EO L
ㅇㅕㅁㅈㅡㅇ	iEO M J EU NG
ㅅㅓㄷㅜㄹㄹㅓㅆㅇㅡㄹ	S EO D U L L EO SS EU L
ㅎㅡㄴㄷㅡㄹㄷㅏ	H EU N D EU L D A
ㅇㅘㅇㅑ	oA iA
ㅇㅏㄶㄱㅔㅆㅈㅣㅁㅏㄴ	A N Kh E t JJ I M A N
ㅈㅡㄹㄱㅓㅂㄴㅔㅇㅛ	J EU L G EO p N E iO
ㅈㅡㄹㄱㅓㅂㄴㅔㅇㅛ	J EU L G EO M N E iO
ㄴㅗㄹㅕㄱㅇㅡㄹ	N O R iEO G EU L
ㄱㅣㅂㅜㄱㅡㅁㅇㅡㄹㅗ	G I B U G EU M EU R O
ㅆㅗㄱ	SS O k
ㅆㅗㄱ	SS O NG
ㅆㅗㄱ	S O Kh
ㅆㅗㄱ	SS O G
ㅆㅗㄱ	SS O Kh
ㅆㅗㄱ	S O NG
ㄱㅣㄷㅏㄹㅕ	G I D A R iEO
ㅅㅣㄹㄹㅕㄱ	S I L L iEO k
ㅈㅜㅅㅣㄱㅔㅆㅇㅓㅇㅛ	J U S I G E SS EO iO
ㅂㅗㅌㅗㅇ	B O Th O NG
ㄴㅏ	N A
ㅇㅜㄹㅣㄱㅏ	U R I G A
ㄴㅏㄹㅆㅣㄱㅏ	N A L SS I G A
ㅁㅏㅇㅡㅁㅇㅔ	M A EU M E
ㅂㅏㅃㅡㄷㅏ	B A BB EU D A
ㄱㅗㅇㅎㅏㅇㅇㅣ	G O NG H A NG I
ㅂㅜㅂㅜ	B U B U
ㅈㅗㅎㄷㅓㄴㄷㅔㅇㅛ	J O Th EO N D E iO
ㄱㅏㅁㅅㅏㅇㅢ	G A M S A euI
ㅎㅣㅁㄷㅡㄹ	H I M D EU L
ㄱㅣㅁㅏㄱㅎㅣㄷㅏ	G I M A Kh I D A
ㅇㅖㅈㅓㅇㅇㅣㅅㅣㅂㄴㅣㄲㅏ	iE J EO NG I S I M N I GG A
ㅇㅣㄹㅇㅡㄹ	I R EU R
ㅇㅣㄹㅇㅡㄹ	I R EU L
ㅈㅗㅎㅈㅣ	J O CHh I
ㅁㅏㄶㅇㅡㄹ	M A N EU L
ㅇㅣㄸㅏ	I DD A
ㅈㅚㅅㅗㅇㅎㅏㅈㅣㅁㅏㄴ	J OE S O NG H A J I M A N
ㅎㅏㄴ	H A N
ㅎㅏㄴ	A N
ㅁㅏㄶㄱㅗ	M A N Kh O
ㅁㅓㄱㅇㅓㄹㅏ	M EO G EO R A
ㄴㅏㅅㅔㅇㅛ	N A S E iO
ㅅㅏㅇㅢ	S A euI
ㅇㅏㅈㅣㄱ	A J I NG
ㅇㅏㅈㅣㄱ	A J I Kh
ㅇㅏㅈㅣㄱ	A J I k
ㅇㅏㅈㅣㄱ	A J I G
ㅅㅣㅍㅅㅡㅂㄴㅣㄷㅏ	S I p SS EU M N I D A
ㄱㅜㄱㅈㅔㅅㅓㄴ	G U k JJ E S EO N
ㅇㅗㅁㅕㄴ	O M iEO N
ㅅㅣㅈㅏㅇㅇㅔ	S I J A NG E
ㅁㅗㅅㅎㅏㄴㄷㅏㅁㅕㄴ	M O Th A N D A M iEO N
ㅇㅣㅂㄱㅜ	I p GG U
ㄱㅕㄹㅈㅓㅇㅇㅡㄴ	G iEO L J EO NG EU N
ㅇㅓㄸㅓㄱㅎㅏㅈㅛ	EO DD EO Kh A CHh iO
ㅇㅓㄸㅓㄱㅎㅏㅈㅛ	EO DD EO Kh A J iO
ㅇㅣㄹㅇㅣㄹㅏㅁㅕㄴ	I R I R A M iEO N
ㅁㅓㄴㅈㅓ	M EO N J EO
ㅂㅜㅇㅓㅋ	B U EO Kh
ㄴㅡㅈㄱㅔ	N EU t GG E
ㄷㅡㄹㅁㅕㄴ	D EU L M iEO N
ㅇㅣㄴㄹㅠ	I N N iU
ㄲㅡㅌㅇㅣ	GG EU Th I
ㄲㅡㄱㅗ	G EU G O
ㅂㅜㄴㅇㅟㄱㅣㄱㅏ	B U N UE G I G A
ㅃㅜㄹㅣ	BB U R I
ㅁㅜㄹㅇㅣ	M U R I
ㅁㅜㄹㅎㅏㄱㅗ	M U R H A G O
ㅇㅕㄹㅅㅣㅁㅎㅣ	iEO L S I M H I
ㄱㅏㅌㅇㅡㄴ	G A Th EU N
ㄱㅝㄴㄹㅕㄱㄱㅘ	G uEO N N iEO k GG oA
ㅇㅓㄷㅣㄹㅗ	EO D I R O
ㄷㅐㄷㅏㄴㅎㅏㄴㅔㅇㅛ	D AE D A N A N E iO
ㅅㅣㅇㅔ	S I E
ㅅㅣㄹㄴㅐ	S I N N AE
ㅌㅚㄱㅡㄴㅎㅏㅈㅣ	Th OE G EU N A J I
ㅂㅐㄱㅗㅍㅏㅇㅛ	B AE G O Ph A iO
ㅁㅏㄹㅆㅡㅁㅎㅐ	M A L SS EU M H AE
ㅅㅜㅇㅓㅂㄹㅛㄱㅏ	S U EO M N iO G A
ㅇㅢㅅㅏ	euI S A
ㄱㅜㅇㄹㅣ	G U NG N I
ㅈㅓㄴㅇㅔ	J EO N E
ㅇㅓㅁㅓㄴㅣ	EO M EO N I
ㅇㅣㅇㅓㄴㅏㄱㅏㄴㅡㄴ	I EO N A G A N EU N
ㄲㅗㅊ	G O S
ㄲㅗㅊ	G O t
ㄲㅗㅊ	GG O t
ㄲㅗㅊ	G O N
ㄲㅗㅊ	G O CHh
ㅇㅗㄴㅡㄹ	O N EU N
ㅇㅗㄴㅡㄹ	O N EU L
ㅇㅗㄴㅡㄹ	O N EU R
ㄱㅡㄴㄹㅗㅈㅏ	G EU N N O J A
ㄷㅏㅇㅈㅏㅇ	D A NG J A NG
ㅊㅏㅇㅁㅜㄴㅇㅣ	CHh A NG M U N I
ㅈㅓㄱㅎㅏㅂㅎㅏㄴ	J EO Kh A Ph A N
ㅈㅣㅅㄴㅜㄹㅡㄷㅏ	J I N N U R EU D A
ㅅㅐㄹㅗ	S AE R O
ㄱㅣㄷㅏㄹㅣㄷㅏ	G I D A R I D A
ㅎㅜㅊㅜ	H U CHh U
ㄷㅏㄹㅋㅗㅁㅎㅏㄴ	D A L Kh O M H A N
ㅇㅏㅀㄷㅓㄴㅣ	A L Th EO N I
ㅇㅏㅀㄷㅓㄴㅣ	A L DD EO N I
ㅇㅏㅀㄷㅓㄴㅣ	A L D EO N I
ㅇㅣㄱㅓㅅ	I G EO t
ㅅㅏㅇㅛㅇㅎㅏㄴㅡㄴ	S A iO NG H A N EU N
ㅋㅣ	Kh I
ㅈㅣㄱㅡㅁ	J I G EU M
ㅊㅣㅁㄷㅐ	CHh I M D AE
ㅎㅡㄺㅁㅏㄹㅜ	H EU NG M A R U
ㅁㅏㄱㅎㅕ	M A Kh iEO
ㄴㅐ	N AE
ㅅㅏㄱㅘ	S A G oA
ㅇㅣㅆㅇㅡㅅㅣㅁㅕㄴ	I S EU S I M iEO N
ㅇㅣㅆㅇㅡㅅㅣㅁㅕㄴ	I SS EU S I M iEO N
ㅃㅏㄹㄹㅐ	BB A L L AE
ㄱㅏㅁㅏㄴㅎㅣ	G A M A N I
ㄱㅡ	G EU
ㅁㅝㄹㅏㄱㅗ	M uEO R A G O
ㅎㅏㄹㅜㅁㅏㄴ	H A R U M A N
ㅂㅐㄱㅎㅘㅈㅓㅁㅇㅡㄹ	B AE Kh oA J EO M EU L
ㅇㅣㅂㄱㅗ	I p GG O
ㄱㅏㅈㄷㅏ	G A t DD A
ㅈㅗㅁ	J O M
ㅂㅏㄲㅇㅡㄴ	B A GG EU N
ㅃㅏㅇ	BB A NG
ㅃㅏㅇ	B A NG
ㄷㅏㄻㅇㅏㅆㅇㅓㅇㅛ	D A L M A SS EO iO
ㅂㅕㄱㅇㅔ	B iEO G E
ㅁㅜㅇㅓㅅㅇㅣㄴㅈㅣ	M U EO S I N J I
ㅅㅣㅇㅅㅣㅇㅎㅏㄷㅏ	S I NG S I NG H A D A
ㄴㅗㄱㄱㅣ	N O k GG I
ㅁㅜㄴㅇㅡㄹ	M U N EU L
ㄹㅏㅁㅕㄴㅇㅣ	R A M iEO N I
ㅇㅓㄹㄱㅜㄹㅇㅣ	EO L G U R I
ㅁㅕㅊ	M iEO S
ㅁㅕㅊ	M iEO CHh
ㅁㅕㅊ	M iEO t
ㅁㅕㅊ	M iEO N
ㄴㅣ	N I
ㅇㅣㅇㅑㄱㅣ	I iA G I
ㄸㅏㄱ	DD A k
ㄸㅏㄱ	D A Kh
ㄸㅏㄱ	D A k
ㄸㅏㄱ	D A G
ㅂㅏㄴㅊㅏㄴ	B A N CHh A N
ㄱㅡㄹㅆㅣ	G EU L SS I
ㅈㅣㅎㅏㅊㅓㄹ	J I A CHh EO L
ㅂㅣㅂㅣㅁㅂㅏㅂ	B I B I M B A p
ㅎㅣㅁㄷㅡㄴ	H I M D EU N
ㄷㅏㄷㅎㅣㄷㅏ	D A Th I D A
ㄷㅏㄷㅎㅣㄷㅏ	Th A Th I D A
ㄱㅗㅇㅎㅏㅇㄱㅘ	G O NG H A NG G oA
ㄱㅓㅅㅇㅡㄹ	G EO S EU L
ㄱㅓㅅㅇㅡㄹ	G EO S EU R
ㅅㅜㄱㅗㅎㅏㄷㅏ	S U G O A D A
ㅊㅐㅅㅗ	CHh AE S O
ㅂㅗㄹㄱㅔㅇㅛ	B O L G E iO
ㅊㅏㅇㅣㅈㅓㅁㅇㅣ	CHh A I J EO M I
ㅂㅜㄹㅁㅏㄴㅇㅣ	B U L M A N I
ㅁㅓㄱㄷㅓㄴ	M EO k DD EO N
ㅇㅣㅆㅇㅡㅁㅕㄴ	I SS EU M iEO N
ㄴㅏㅁㅜㅅㅇㅣㅍ	N A M U S I Ph
ㄴㅏㅁㅜㅅㅇㅣㅍ	N A M U S I p
ㄴㅏㅁㅜㅅㅇㅣㅍ	N A M U S I M
ㄷㅚㄹㄲㅏㅇㅛ	D OE L GG A iO
ㅎㅏㄱㅔㅆㅇㅓㅇㅛ	A G E SS EO iO
ㅈㅣㅅㅇㅣㄷㅏ	J I S I D A
ㅇㅣㄱㅓ	I G EO
ㅈㅣㄱㅈㅏㅇㅇㅣ	J I k JJ A NG I
ㅇㅓㅂㅁㅜㅇㅔ	EO M M U E
ㄱㅜㅎㅏㄷㅏ	G U A D A
ㅅㅏㄹㅓ	S A R EO
ㅈㅏㄹㅣ	J A R I
ㄲㅗㅊㅇㅡㄹ	GG O CHh EU L
ㅇㅑㄱㅜ	iA G U
ㅇㅣㄴㅈㅓㅇㄷㅚㄴ	I N J EO NG D OE N
ㄱㅛㅇㅠㄱㅇㅕㄹ	G iO iU G iEO R
ㄲㅡㅂㅅㅣㄷㅏ	G EU p SS I D A
ㄷㅏ	D A
ㄷㅏ	Th A
ㄱㅙㄴㅊㅏㄶㄷㅏ	G O AE N CHh A N Th A
ㅈㅗㅇㄹㅗ	J O NG N O
ㅇㅓㄸㅐㅇㅛ	EO DD AE iO
ㅎㅏㄴㄱㅜㄱㅇㅓ	A N G U G EO
ㅎㅏㄴㄱㅜㄱㅇㅓ	H A N G U G EO
ㅍㅕㄴㅈㅣ	Ph iEO N J I
ㅇㅓㅄㅇㅡㅁㅕㄴ	EO p SS EU M iEO N
ㅅㅏㅇㄱㅡㅁ	S A NG G EU M
ㄹㅏㅁㅕㄴ	R A M iEO N
ㄹㅏㅁㅕㄴ	L A M iEO N
ㅅㅣㄱㄷㅏㅇㅇㅔ	S I k DD A NG E
ㅅㅓㅇㅈㅏㅇㅎㅐㅆㅅㅡㅂㄴㅣㄷㅏ	S EO NG J A NG H AE S SS EU M N I D A
ㅎㅐㄱㅅㅣㅁㅇㅣ	H AE k SS I M I
ㅈㅗㅎㅇㅏㅎㅏㅅㅔㅇㅛ	J O A A S E iO
ㄷㅚㄴㅡㄴㄷㅔ	D OE N EU N D E
ㅍㅕㄴㅎㅏㄴ	Ph iEO N A N
ㄴㅓㅁㅜ	N EO M U
ㅇㅣㄱㅔ	I G E
ㅈㅜㅇㅇㅔㅅㅓ	J U NG E S EO
ㅅㅜ	S U
ㅈㅘㅅㅓㄱ	J oA S EO NG
ㅈㅘㅅㅓㄱ	J oA S EO k
ㅈㅓㄹㅓㅎㄱㅔ	J EO R EO Kh E
ㅎㅐㄱㅕㄹㅇㅡㄹ	H AE G iEO R EU L
ㅎㅐ	AE
ㅎㅐ	H AE
ㅂㅜㅌㅇㅓ	B U Th EO
ㅈㅣㅂㅈㅣㅂㅁㅏㄷㅏ	J I p JJ I M M A D A
ㄴㅜㄱㅜㅎㅏㄱㅗ	N U G U A G O
ㅁㅏㄷㅇㅣ	M A D I
ㅅㅣㄴㄱㅗ	S I N G O
ㅇㅞㄴ	U E N
ㅇㅏㄵㅇㅏㅅㅓ	A N J A S EO
ㅇㅣㄹㅉㅣㄱ	I L JJ I k
ㅅㅣㅎㅓㅁ	S I EO M
ㄲㅗㄱ	GG O k
ㄲㅗㄱ	G O k
ㅈㅗㅎㄱㅔㅆㅇㅓㅇㅛ	J O Kh E SS EO iO
ㅇㅕㅇㅇㅓ	iEO NG EO
ㅍㅏㄹㅍㅏㄹ	Ph A L Ph A L
ㄷㅡㅅㅔㅇㅛ	Th EU S E iO
ㄷㅡㅅㅔㅇㅛ	D EU S E iO
ㅇㅏㄴㅣㅇㅑ	A N I iA
ㄱㅡㅁㅏㄴ	G EU M A N
ㄱㅏㄱㅔ	G A G E
ㅂㅗㅈㅏㄱㅣ	B O J A G I
ㅇㅕㄷㅓㄼ	iEO D EO L B
ㅎㅏㄴㅂㅓㄴ	H A N B EO N
ㅎㅏㄴㄱㅜㄱㅁㅏㄹㅇㅡㄹ	H A N G U NG M A R EU L
ㄷㅡㅇㄹㅗㄱㄱㅡㅁㅇㅔ	D EU NG N O k GG EU M E
ㅇㅓㅄㅇㅡㄹㄲㅏㅇㅛ	EO p SS EU L GG A iO
ㅎㅐㅆㄴㅡㄴㅈㅣ	H AE N N EU N J I
ㄲㅐㄲㅡㅅㅇㅣ	GG AE GG EU S I
ㄱㅜㄱㅁㅣㄴ	G U NG M I N
ㅇㅣㄹ	I R
ㅇㅣㄹ	I L
ㅇㅣㄹ	I N
ㅌㅏㄱㅗ	Th A G O
ㅎㅐㄷㅗ	H AE D O
ㅁㅜㄴ	M U N
ㄱㅝㄴㅎㅏㄷㅏ	G uEO N A D A
ㄷㅟㅅㅇㅣㄹㅇㅡㄴ	D UE S I R EU N
ㄱㅓㄷㅎㅣㄴ	G EO Th I N
ㅎㅏㅅㅣㄹ	H A S I N
ㅎㅏㅅㅣㄹ	H A S I R
ㅎㅏㅅㅣㄹ	H A S I L
ㄷㅡㄹㅇㅓㅇㅛ	D EU R EO iO
ㅇㅣㄹㅓㅎㄱㅔ	I R EO Kh E
ㅂㅜㅌㅇㅣㅅㅔㅇㅛ	B U Th I S E iO
ㅂㅏㄹㅏㅁㅈㅣㄱㅎㅏㅈㅣ	B A R A M J I Kh A J I
ㄷㅏㄹㅡㄷㅏㄴㅡㄴ	D A R EU D A N EU N
ㅅㅐㅇㄱㅏㄱㅎㅏㄱㅗ	S AE NG G A Kh A G O
ㅈㅓㅇㄷㅗㄹㅗ	J EO NG D O R O
ㅆㅗㄷㅇㅏㅇㅛ	SS O D A iO
ㅈㅓㅁ	J EO M
ㅂㅏㅇㅇㅔㅅㅓ	B A NG E S EO
ㅇㅣㅆㄷㅗㄹㅗㄱ	I t DD O R O k
ㅅㅣㄹㅅㅜㅎㅏㅈㅣ	S I L S U A J I
ㅂㅕㄹㅇㅣㄹ	B iEO R I R
ㅂㅕㄹㅇㅣㄹ	B iEO R I N
ㅂㅕㄹㅇㅣㄹ	B iEO R I L
ㅁㅕㅊㅣㄹ	M iEO CHh I L
ㅁㅓㄱㅇㅡㄹㄱㅓㄹ	M EO G EU L G EO R
ㅁㅓㄱㅇㅡㄹㄱㅓㄹ	M EO G EU L G EO L
ㄱㅏㅌㅇㅣ	G A Th I
ㅇㅕㄱㅣㄲㅏㅈㅣ	iEO G I GG A J I
ㅇㅏㄴ	A N
ㅉㅏㅇㅛ	J A iO
ㅉㅏㅇㅛ	JJ A iO
ㅅㅐㅇㄱㅏㄱ	S AE NG G A k
ㄱㅏㄴㅅㅣㄱ	G A N S I k
ㅇㅑㄱㄱㅜㄱ	iA k GG U k
ㅂㅘㅇㅛ	B oA iO
ㅌㅚㄱㅡㄴ	Th OE G EU N
ㅈㅓㄴㅌㅗㅇㅇㅡㄹ	J EO N Th O NG EU L
ㅍㅗㅎㅏㅁㄷㅙㅇㅛ	Ph O A M D O AE iO
ㅃㅏㄹㄹㅣ	BB A L L I
ㅇㅢㄱㅕㄴㄹㅏㄴㅇㅔ	euI G iEO N N A N E
ㄱㅏㄹㄲㅏ	G A L GG A
ㅍㅗㄱㅂㅏㄹ	Ph O k BB A L
ㄷㅜㅂㅜ	D U B U
ㅇㅘㅅㅓ	oA S EO
ㄸㅏㄸㅡㅅㅎㅏㅈㅣㅇㅛ	DD A DD EU Th A J I iO
ㄸㅏㄸㅡㅅㅎㅏㅈㅣㅇㅛ	D A DD EU Th A J I iO
ㅈㅗㅎㅇㅡㄹㄲㅏㅇㅛ	J O EU L GG A iO
ㅎㅏㄴㅡㄴ	A N EU N
ㅎㅏㄴㅡㄴ	H A N EU N
ㄲㅗㄹㅣ	GG O R I
ㅇㅣㄹㅡㅁㅇㅣ	I R EU M I
ㄱㅖㅅㅔㅇㅛ	G iE S E iO
ㅂㅏㄹㄷㅡㅇ	B A L D EU NG
ㅇㅣㅎㅐㅎㅏㄱㅣ	I AE A G I
ㅁㅗㄷㅜ	M O D U
ㄱㅓㅇㅑ	G EO iA
ㅇㅣㄹㅇㅡㄴ	I R EU N
ㅉㅣㄱㅇㅓㅇㅑ	JJ I G EO iA
ㅃㅏㅈㅕㅆㄴㅔㅇㅛ	BB A J iEO N N E iO
ㅂㅏㅇㅅㅗㅇ	B A NG S O NG
ㅁㅏㄹㅎㅐ	M A R H AE
ㅎㅘㄱㅏ	oA G A
ㅎㅘㄱㅏ	H oA G A
ㄴㅓ	N EO
ㅎㅢㅁㅏㅇ	H euI M A NG
ㅇㅟ	UE
ㄷㅗㄴㅇㅡㄴ	D O N EU N
ㅈㅜㅁㅏㄹㅇㅔ	J U M A R E
ㅈㅗㅎㅇㅡㄴㄷㅔ	J O EU N D E
ㅈㅔㄱㅏ	J E G A
ㄲㅡㅌㄴㅏㅆㅇㅡㄹㄱㅓㄹ	GG EU N N A SS EU L G EO L
ㄲㅡㅌㄴㅏㅆㅇㅡㄹㄱㅓㄹ	GG EU N N A SS EU L G EO N
ㄲㅡㅌㄴㅏㅆㅇㅡㄹㄱㅓㄹ	GG EU N N A SS EU L G EO R
ㄱㅣㅁㅊㅣ	G I M CHh I
ㄱㅏㅍㅇㅏㅆㄷㅏ	G A Ph A t DD A
ㅁㅗㅅㅎㅏㄱㅔㅆㅅㅡㅂㄴㅣㄷㅏ	M O Th A G E S SS EU M N I D A
ㄲㅡㅀㄴㅡㄴㄷㅔ	G EU N N EU N D E
ㅇㅗㅅㅇㅣㄹㅏㄱㅗ	O S I R A G O
ㄷㅏㅅㅓㅅ	D A S EO t
ㅂㅗㄴㅣ	B O N I
ㅇㅝㄴㅁㅏㄴ	uEO N M A N
ㅅㅜㄹㅣ	S U R I
ㅇㅏㅂㅓㅈㅣㅇㅘ	A B EO J I oA
ㄱㅏㅆㄷㅏ	G A t DD A
ㅇㅓㄷㅣ	EO D I
ㅁㅣㄹㅣ	M I R I
ㅇㅖㅅㄴㅏㄹ	iE N N A L
ㅇㅣㅆㅇㅓㅇㅛ	I SS EO iO
ㅈㅓㅂㅅㅜ	J EO p SS U
ㅇㅓㄸㅓㅎㄱㅔ	EO DD EO Kh E
ㄱㅡㄹㅓㅎㄱㅔ	G EU R EO Kh E
ㅅㅟㅂㅈㅣ	S UE p JJ I
ㅊㅐㄱㅇㅣㅁㅇㅣㅇㅑ	CHh AE G I M I iA
ㅈㅜㅅㅔㅇㅛ	J U S E iO
ㅂㅘㅆㄴㅡㄴㄷㅔ	B oA N N EU N D E
ㅂㅐㄱ	B AE NG
ㅂㅐㄱ	B AE Kh
ㅂㅐㄱ	B AE G
ㅂㅐㄱ	B AE k
ㅅㅏㄹㅇㅣ	S A R I
ㅇㅢㅈㅏ	euI J A
ㄱㅏㅈㅏ	G A J A
ㅂㅏㅂ	B A p
ㅂㅏㅂ	B A M
ㅇㅢㄱㅕㄴㅇㅣ	euI G iEO N I
ㅇㅓㄴㅈㅔㄷㅡㄴㅈㅣ	EO N J E D EU N J I
ㅅㅏㅈㅣㄴㅇㅡㄹ	S A J I N EU L
ㅎㅐㄷㅗㄷㅇㅣ	H AE D O D I
ㅇㅣㄹㅂㅗㄴ	I L B O N
ㅈㅗㅎㅇㅡㄴ	J O EU N
ㅁㅝㄴㅈㅣ	M uEO N J I
ㅇㅘㅆㅇㅓㅇㅛ	oA SS EO iO
ㅈㅣㄱㅈㅓㅂ	J I k JJ EO p
ㅇㅓㅄㄷㅏ	EO p DD A
ㄱㅓ	G EO
ㅈㅜㅇㄱㅜㄱ	J U NG G U k
ㅈㅓㅎㅢ	J EO euI
ㅅㅏㄹㅏㅁㅇㅣ	S A R A M I
ㅈㅣㄴㅉㅏ	J I N JJ A
ㅉㅣㄱㅇㅡㅁㅕㄴ	JJ I G EU M iEO N
ㅁㅓㄱㅇㅓㅇㅛ	M EO G EO iO
ㅇㅟㅎㅐ	UE AE
ㅂㅜㅇㅓㅋㅇㅔ	B U EO Kh E
ㅇㅗㄴㅡㄹㅇㅡㄴ	O N EU R EU N
ㄱㅕㄲㄷㅏ	G iEO k DD A
ㅊㅣㄴㄱㅜ	CHh I N G U
ㅂㅏㄲㅜㄷㅏ	B A GG U D A
ㄱㅡㅂㅎㅏㄴ	G EU Ph A N
ㅇㅙ	O AE
ㅇㅏㄶㅇㅡㄹ	A N EU L
ㅂㅜㄴ	B U N
ㄷㅏㄷㅇㅏ	D A D A
ㄴㅐㄱㅏ	N AE G A
ㄱㅏㅆㅈㅣ	G A t JJ I
ㄱㅜㄱㄴㅐㅅㅓㄴ	G U NG N AE S EO N
ㅈㅜㄹ	J U L
ㅅㅣㄲㅏㅈㅣ	S I GG A J I
ㅈㅓㄹㄷㅐㄹㅗ	J EO L D AE R O
ㅇㅏㄶㅇㅡㅅㅕㅆㅇㅓㅇㅛ	A N EU S iEO SS EO iO
ㄱㅔ	Kh E
ㄱㅔ	G E
ㄴㅏㄱㅏㅆㄴㅡㄴㄷㅔ	N A G A N N EU N D E
ㅈㅗㅎㄱㅔㅆㄴㅔㅇㅛ	J O Kh E N N E iO
ㄷㅙㅇㅛ	D O AE iO
ㅇㅓㄴㄴㅣ	EO N N I
ㅇㅕㄱㅝㄴ	iEO G uEO N
ㄷㅓ	D EO
ㄷㅓ	Th EO
