NG	ㅇ	
G	ㄱ
E	ㅔ
U	ㅜ	
iO	ㅛ
O	ㅗ	
OE	ㅚ
CHh	ㅊ	
oA	ㅘ
Kh	ㅋ
Th	ㅌ
JJ	ㅉ
t	ㄷ	
D	ㄷ
GG	ㄲ
iEO	ㅕ
A	ㅏ
iE	ㅖ
M	ㅁ
EO	ㅓ
k	ㄱ
iA	ㅑ
SS	ㅆ
p	ㅂ
Ph	ㅍ
BB	ㅃ
I	ㅣ
S	ㅅ
iU	ㅠ	
euI	ㅢ
H	ㅎ
J	ㅈ
R	ㄹ
uEO	ㅝ
DD	ㄸ	
EU	ㅡ
B	ㅂ
N	ㄴ
L	ㄹ
AE	ㅐ
UE  ㅟ
